--------------------
---p----------------
---------fff----k---
--------fff---------
#------------------@
--------------------
-----ss-------------
-----ss-------------
--------------------
--------------------
