--------------------
---------ss---------
----------s----p----
@-------------------
------ff------------
------ff-----------#
---k----------------
--------------------
--------------------
--------------------
