---------fff--------
----------fs-----p--
--k-ss----sss-------
----ss----sss----ff@
----fffff--ss---sff-
#---ffff--------fs--
----fff----------s--
-sss----------------
-ss-------fffff-----
-----------fff------
