#--------------ss--p
----ffff-------ss---
----ffff-------ss---
--------------------
----------ss--------
----------s---------
--------------------
-----------f--------
----------ff--------
k---------f--------@
