--------------------
--------ff------p---
--------ff----------
#-------ff----------
------f-ff----------
------fff-ss-------@
----------ss--------
--k-------ss--------
--------------------
--------------------
