--------------------
--------sss---------
--------sss---------
---ff---------------
---ff---------------
---ff---------------
---f------p---------
----------p---------
------#--@----------
--------------------
